25;pink;
#########################
#########################
#########################
###....#.........#....###
###*##.#.#######.#.##*###
###...................###
####.#.####.#.####.#.####
####.#.####.#.####.#.####
####.#......#......#.####
####.###O#######O###.####
####.OOOOOFOOOFOOOOO.####
####.###O#######O###.####
####.#OOO#######OOO#.####
####.#O#O#######O#O#.####
####.OO#OOOOOOOOO#OO.####
####.######O#O######.####
####......OO#OO......####
####.####.#####.####.####
###.........P.........###
###.###.###.#.###.###.###
###.###.#...#...#.###.###
###*###.#.#####.#.###*###
###...................###
#########################
#########################